BD55155157
85512D5693
AF96AFFD6A
EFEF817F96
BFFFAEFBC3
C3BFAFD412
946FAFFFAE
8797C11787
C383D2E943
D46C54547E

0,0
9,9
SEEEESSSSSSESSEENEES
