9139151111111111111115113
8000410040028040402801042
AC00140010280038140000012
850401000040400003806A82A
8105000280101004000010002
8001282800280401400040002
8280400028000140128010282
8000104004004010000004002
8000041041041042C00281402
A82A810014010450102800502
800000402F842FFC040280102
840040102FEF817F812840402
C10012842FFF86F928001012A
90040001013FAFD4000040002
84014004006FAFFF802852802
8504100100110515028010282
8101028000280101000040402
8400402828400440284010102
8100128000100150005004006
8002800402800038281001003
A82C00010002C000000282802
800102804000100428280002A
84040282902C0003800000002
8101000004010280028028282
C444444445444444446C44446

0,0
24,23
SSSSSSSSSSSSESSESSSSSESEEESEEEEEEEEEESEEEEEEESE