9111111111111111111111113
8028000000040000000000002
8000004040010000028000402
8006801010400282800280102
8001028040128400000000402
8028000010280100428000102
8002800280000400140282802
8004028028400100010000002
8001000400100428040280402
8004400504028540010000502
800390012F842FFC000280382
800004002FEF817F828000002
82C00102AFFF86F9000068002
80140040013FAFD4000010282
8001001002AFAFFF82A804002
8004004280014113800001282
8001401000001000004000002
8000100002842828041028402
8284042828010000010400102
8001014000280400004104002
8000041004028102C01001002
8028010003800040102800002
8004040280004010000028282
8001010004001000280400002
C44444444544446C444544446

0,0
24,23
SSSSSSSSSSSSSSSSSSSSEEESEEEEESEEEEEEEEESEEEEEEE