9151111111151153911151113
8010004040010010028010282
8002801010400028000040002
A828000400502800280410042
8000280380128000000140012
8028000000000068040010402
8280042C02804010010000502
8000010100001000000280102
80028004040040282A8280402
8284028105001440000000102
828100006F842FFC000000042
802840043FEF817FA82828012
C00010012FFF86F9000400282
90040040413FAFD4004100402
84014010102FAFFFA81004102
8100100440010511000401002
8004000110004100400102A82
A801028040281000104000002
8284280010000282801028282
8001000004028400004000002
8000002A81000104281028042
A828280002800401000400052
8000000400028144004100012
8280400102800011001028042
C444544444444444444444456

0,0
24,23
SSSSSSSSSSSSESSESSSSSEEEEEESEESEESEEEEEEEEESEEE