9119111111999191919199113
88A880000828008488000080A
808048084088400180482828A
808898281804908288108800A
88A8A88004090A8808888048A
8840000C038880C02A8A80982
80908401A882881080080008A
88C80D08080C084008A82828A
8018012C00C18098A8808000A
8288C00904908C408288C8042
80041808AF84AFFC080050812
808108A8AFEF817F808810C0A
888C2800AFFF8EF90AC008902
8801880C017FAFD40098A8C02
80088001883FAFFF8C0040102
88A82A828009019901001880A
80800808A88A804080A88A802
80080C080A880090A80828002
88A88128008C000800884408A
8008A80280810EA8AA8851842
88A8088006A88908088818012
8080002809800288480088882
884828880C02888838A8A828A
8090804889000848080880002
C4C444544444CC54C4C4CC4C6

0,0
24,23
SSSSSSSSSSSSSSSSSSSSSSSEEEEEEEEEEEEEEEEEEEEEEEE